****************************************
*@.....................................*
*......................................*
*......................................*
*......................................*
*......................................*
*......................................*
*......................................*
*......................................*
*......................................*
*......................................*
*.....................****.............*
*.....................*................*
*.....................*................*
*.............*********................*
*.............*********................*
*.............*********................*
*.............*********................*
*......................................*
*......................................*
*......................................*
*......................................*
*......................................*
*......................................*
*......................................*
*......................................*
*......................................*
*......................................*
*......................................*
****************************************
